########################
#P%%%&&%%%%%&&&%#%%&&P%#
#%#&#%##%##%%&%%&%##%%%#
#%%%%%%%#&##&&##%&&&#%%#
#%#&&###%#&&#%%##%##%#%#
##%%%%#%&&###%###%##%#%#
###&&&##%&###%###%##%#%#
###%%%%&&&%%%%##&####%%#
#%%#####%###%##%&####&%#
##%%####%###&#&&%%%%%%%#
###&&&##%###&&##%####%%#
###&%%%#####&%%%%###%&&#
#%%&######%%P##&&####&%#
###&&%%&&###%%%&&&###&&#
#%%%&&&##%%%&####%%%%%%#
########################