########################
#%%%%&&%%%%%&&&%#%%&&%%#
#%#&#%##%##%%&%%&%##%%%#
#%%%%%%%#&##&&##%&&&#%%#
#%#&&###%#&&#%%##%##%#%#
##%%%%#%&&###%###%##%#%#
###&&&##%&###%###%##%#%#
###%%%%&&&%%%%##&####%%#
#%%#####%###%##%&####&%#
##%%####%###&#&&%%%%%%%#
###&&&##%###&&##%####%%#
###&%%%#####&%%%%###%&&#
#%%&######%%%##&&####&%#
###&&%%&&###%%%&&&###&&#
#%%%&&&##%%%&####%%%%%%#
########################