########################
#%%%%&&%%%&&&#&%#%%&&&%#
#%#&#%##%#P%%#%%&%##%%&#
#%%%%%%%#&%#&&&#%&&&#%&#
#%#&&###%#&&#%%##%##%#%#
##%%%%#%&&%##%###%&&%#%#
###&&&##%&###%###%##%#%#
##&%%%%&&&%%%%##&&###%%#
#%%##&##%###%##%&####&%#
##%%####%###&#&&%%%#%%%#
###&&&#&%###&&##%#&##%%#
###&%&%%####&%%%%#P#%&&#
#P&%######%%%##&&#%%#&%#
#%#&&%%&&%##%%%&&&#%#&&#
#%%%&&&##%%%&####%%&%%%#
########################