########################
#%#%%&&%%%&&&#&%#%%&&&%#
#%#&#%##%#&%%#%%&%##P%&#
#%%%%%%%#&%#&&&#%&&&#%&#
#%#&&###%#&&#%%##%##%#%#
##%%%%#%&&%##%###%##%&%#
###&&&##%&###&###%##%###
##&%%%%&&&P%%%##&####%%#
#%%#####%#&#%##%&####&%#
##%%####%#%#&#&&%%%#%%%#
###&&&#&%#&#&&##%#&##%%#
###&%&%%##&#&%%%%#%#%&&#
#%&%######%%%##&&#%%#&%#
#%#&&%%&&%##%%%&&&#%#&&#
#%%%&&&##P%%&####%%&%%%#
########################